AMH	А.ч
AMP	А
ANN	г; лет
BAR	бар
CDL	кд
CEL	град. C
CMK	см2
CMT	см
CT	упак
DKL	дал
DAY	сут; дн
DMT	дм
DZN	дюжина
FOT	фут
GRM	г
GWH	ГВт.ч
HBX	100 ящ.
HLT	гл
HTZ	Гц
HUR	ч
INH	дюйм
JOU	Дж
KEL	K
KGM	кг
KHZ	кГц
KJO	кДж
KMH	км/ч
KPA	кПа
KTM	км
KVA	кВ.А
KVT	кВ
KWH	кВт.ч
KWT	кВт
LTR	л
LUX	лк
MAW	МВт
MGM	мг
MHZ	МГц
MIN	мин
MLT	мл
MMQ	мм3
MMT	мм
MON	мес
MPA	МПа
MTQ	м3
MTK	м2
MTR	м
MWH	МВт.ч
NAR	изд
NEW	Н
PA	упак
PAL	Па
PCE	шт
QAN	кварт
RO	рулон
RPM	об/мин
TNE	т
VLT	В
WHR	Вт.ч
WTT	Вт
YRD	ярд